wwwwwwwwwwwwwwwwwwwwwwwwwwwwwwwwwwwwwwwww
w                                      .w
w                                      .w
w                                       w
w      4                                w
w *                                     w
w      5                                w
w                                       w
w                                       w
w                                       w
wwwwwwwwwwwwwwwwwwwwwwwwwwwwwwwwwwwwwwwww
w.                                      w
w.                                      w
w                                       w
w                                e      w
w                                     * w
w                                t      w
w                                       w
w                                       w
w9876                               0123w
wwwwwwwwwwwwwwwwwwwwwwwwwwwwwwwwwwwwwwwww